[numoftap]
1
type=Tile Layer 1
data=
0,1,0,1,0,1,0,
0,0,0,0,0,0,0,
0,0,0,0,0,1,0,
0,0,0,0,0,0,0,
0,1,0,1,0,1,0,
0,0,0,0,0,0,0,
0,1,0,1,0,1,0.